524 PARTICIPACOES S.A.	524 PARTICIP	MB
ADVANCED DIGITAL HEALTH MEDICINA PREVENTIVA S.A.	ADVANCED-DH	
AES TIETE ENERGIA SA	AES TIETE E	N2
AFLUENTE TRANSMISSÃO DE ENERGIA ELÉTRICA S/A	AFLUENTE T	
ALEF S.A.	ALEF S/A	MB
ALFA HOLDINGS S.A.	ALFA HOLDING	
ALGAR TELECOM S/A	ALGAR TELEC	
ALIANSCE SHOPPING CENTERS S.A.	ALIANSCE	NM
ALPARGATAS S.A.	ALPARGATAS	N1
ALPER CONSULTORIA E CORRETORA DE SEGUROS S.A.	ALPER S.A.	NM
ALTERE SECURITIZADORA S.A.	ALTERE SEC	
ALUPAR INVESTIMENTO S/A	ALUPAR	N2
AMBEV S.A.	AMBEV S/A	
AMPLA ENERGIA E SERVICOS S.A.	AMPLA ENERG	
ANDRADE GUTIERREZ PARTICIPACOES S.A.	AGPART	MB
ANIMA HOLDING S.A.	ANIMA	NM
AREZZO INDÚSTRIA E COMÉRCIO S.A.	AREZZO CO	NM
ATACADÃO S.A.	CARREFOUR BR	NM
ATOM EMPREENDIMENTOS E PARTICIPAÇÕES S.A.	ATOMPAR	
AZEVEDO E TRAVASSOS S.A.	AZEVEDO	
AZUL S.A.	AZUL	N2
B2W - COMPANHIA DIGITAL	B2W DIGITAL	NM
B3 S.A. - BRASIL, BOLSA, BALCÃO	B3	NM
BAHEMA S.A.	BAHEMA	MA
BANCO INTER S.A.	BANCO INTER	N1
BANESTES S.A. - BCO EST ESPIRITO SANTO	BANESTES	
BARDELLA S.A. INDUSTRIAS MECANICAS	BARDELLA	
BATTISTELLA ADM PARTICIPACOES S.A.	BATTISTELLA	
BAUMER S.A.	BAUMER	
BB SEGURIDADE PARTICIPAÇÕES S.A.	BBSEGURIDADE	NM
BBM LOGISTICA S.A.	BBMLOGISTICA	MA
BCO ABC BRASIL S.A.	ABC BRASIL	N2
BCO ALFA DE INVESTIMENTO S.A.	ALFA INVEST	
BCO AMAZONIA S.A.	AMAZONIA	
BCO BRADESCO S.A.	BRADESCO	N1
BCO BRASIL S.A.	BRASIL	NM
BCO BTG PACTUAL S.A.	BTGP BANCO	
BCO ESTADO DE SERGIPE S.A. - BANESE	BANESE	
BCO ESTADO DO PARA S.A.	BANPARA	
BCO ESTADO DO RIO GRANDE DO SUL S.A.	BANRISUL	N1
BCO INDUSVAL S.A.	INDUSVAL	N2
BCO MERCANTIL DE INVESTIMENTOS S.A.	MERC INVEST	
BCO MERCANTIL DO BRASIL S.A.	MERC BRASIL	
BCO NORDESTE DO BRASIL S.A.	NORD BRASIL	
BCO PAN S.A.	BANCO PAN	N1
BCO PATAGONIA S.A.	PATAGONIA	DR3
BCO PINE S.A.	PINE	N2
BCO SANTANDER (BRASIL) S.A.	SANTANDER BR	
BETA SECURITIZADORA S.A.	BETA SECURIT	
BETAPART PARTICIPACOES S.A.	BETAPART	MB
BICICLETAS MONARK S.A.	BIC MONARK	
BIOMM S.A.	BIOMM	MA
BIOSEV S.A.	BIOSEV	NM
BIOTOSCANA INVESTMENTS S.A.	BIOTOSCANA	DR3
BK BRASIL OPERAÇÃO E ASSESSORIA A RESTAURANTES SA	BK BRASIL	NM
BNDES PARTICIPACOES S.A. - BNDESPAR	BNDESPAR	MB
BOMBRIL S.A.	BOMBRIL	
BR HOME CENTERS S.A.	BR HOME	MA
BR MALLS PARTICIPACOES S.A.	BR MALLS PAR	NM
BR PROPERTIES S.A.	BR PROPERT	NM
BRADESCO LEASING S.A. ARREND MERCANTIL	BRADESCO LSG	
BRADESPAR S.A.	BRADESPAR	N1
BRASIL BROKERS PARTICIPACOES S.A.	BR BROKERS	NM
BRASIL PHARMA S.A.	BR PHARMA	NM
BRASILAGRO - CIA BRAS DE PROP AGRICOLAS	BRASILAGRO	NM
BRASKEM S.A.	BRASKEM	N1
BRAZIL REALTY CIA SECURIT. CRÉD. IMOBILIÁRIOS	BRAZIL REALT	
BRAZILIAN FINANCE E REAL ESTATE S.A.	BRAZILIAN FR	
BRAZILIAN SECURITIES CIA SECURITIZACAO	BRAZILIAN SC	
BRB BCO DE BRASILIA S.A.	BRB BANCO	
BRC SECURITIZADORA S.A.	BRC SECURIT	
BRF S.A.	BRF SA	NM
BRPR 55 SECURITIZADORA CRED IMOB S.A.	BRPR 55 SEC	
BRPR 56 SECURITIZADORA CRED IMOB S.A.	BRPR 56 SEC	
BRQ SOLUCOES EM INFORMATICA S.A.	BRQ	MA
BV LEASING - ARRENDAMENTO MERCANTIL S.A.	BV LEASING	
CABINDA PARTICIPACOES S.A.	CABINDA PART	MB
CACHOEIRA PAULISTA TRANSMISSORA ENERGIA S.A.	CACHOEIRA	MB
CACONDE PARTICIPACOES S.A.	CACONDE PART	MB
CAMBUCI S.A.	CAMBUCI	
CAMIL ALIMENTOS S.A.	CAMIL	NM
CAPITALPART PARTICIPACOES S.A.	CAPITALPART	MB
CCR S.A.	CCR SA	NM
CCX CARVÃO DA COLÔMBIA S.A.	CCX CARVAO	NM
CELULOSE IRANI S.A.	CELUL IRANI	
CEMEPE INVESTIMENTOS S.A.	CEMEPE	
CEMIG DISTRIBUICAO S.A.	CEMIG DIST	
CEMIG GERACAO E TRANSMISSAO S.A.	CEMIG GT	
CENTRAIS ELET BRAS S.A. - ELETROBRAS	ELETROBRAS	N1
CENTRAIS ELET DE SANTA CATARINA S.A.	CELESC	N2
CENTRAIS ELET DO PARA S.A. - CELPA	CELPA	
CENTRO DE IMAGEM DIAGNOSTICOS S.A.	ALLIAR	NM
CESP - CIA ENERGETICA DE SAO PAULO	CESP	N1
CIA BRASILEIRA DE DISTRIBUICAO	P.ACUCAR-CBD	N1
CIA CATARINENSE DE AGUAS E SANEAM.-CASAN	CASAN	
CIA CELG DE PARTICIPACOES - CELGPAR	CELGPAR	
CIA DISTRIB DE GAS DO RIO DE JANEIRO-CEG	CEG	
CIA ELETRICIDADE EST. DA BAHIA - COELBA	COELBA	
CIA ENERGETICA DE BRASILIA	CEB	
CIA ENERGETICA DE MINAS GERAIS - CEMIG	CEMIG	N1
CIA ENERGETICA DE PERNAMBUCO - CELPE	CELPE	
CIA ENERGETICA DO CEARA - COELCE	COELCE	
CIA ENERGETICA DO MARANHAO - CEMAR	CEMAR	MB
CIA ENERGETICA DO RIO GDE NORTE - COSERN	COSERN	
CIA ESTADUAL DE DISTRIB ENER ELET-CEEE-D	CEEE-D	N1
CIA ESTADUAL GER.TRANS.ENER.ELET-CEEE-GT	CEEE-GT	N1
CIA FERRO LIGAS DA BAHIA - FERBASA	FERBASA	N1
CIA FIACAO TECIDOS CEDRO CACHOEIRA	CEDRO	N1
CIA GAS DE SAO PAULO - COMGAS	COMGAS	
CIA HABITASUL DE PARTICIPACOES	HABITASUL	
CIA HERING	CIA HERING	NM
CIA INDUSTRIAL CATAGUASES	IND CATAGUAS	
CIA LOCAÇÃO DAS AMÉRICAS	LOCAMERICA	NM
CIA MELHORAMENTOS DE SAO PAULO	MELHOR SP	
CIA PARANAENSE DE ENERGIA - COPEL	COPEL	N1
CIA PARTICIPACOES ALIANCA DA BAHIA	PAR AL BAHIA	
CIA PAULISTA DE FORCA E LUZ	PAUL F LUZ	
CIA PIRATININGA DE FORCA E LUZ	CPFL PIRATIN	
CIA SANEAMENTO BASICO EST SAO PAULO	SABESP	NM
CIA SANEAMENTO DE MINAS GERAIS-COPASA MG	COPASA	NM
CIA SANEAMENTO DO PARANA - SANEPAR	SANEPAR	N2
CIA SEGUROS ALIANCA DA BAHIA	SEG AL BAHIA	
CIA SIDERURGICA NACIONAL	SID NACIONAL	
CIA TECIDOS NORTE DE MINAS COTEMINAS	COTEMINAS	
CIA TECIDOS SANTANENSE	SANTANENSE	
CIBRASEC - COMPANHIA BRASILEIRA DE SECURITIZACAO	CIBRASEC	
CIELO S.A.	CIELO	NM
CIMS S.A.	CIMS	
CINESYSTEM S.A.	CINESYSTEM	MA
CONC AUTO RAPOSO TAVARES S.A.	CONC RAPOSO	
CONC DO AEROPORTO INTERNACIONAL DE GUARULHOS S.A.	GRUAIRPORT	MB
CONC ECOVIAS IMIGRANTES S.A.	ECOVIAS	
CONC RIO-TERESOPOLIS S.A.	CONC RIO TER	MB
CONC ROD AYRTON SENNA E CARV PINTO S.A.-ECOPISTAS	ECOPISTAS	
CONC ROD.OESTE SP VIAOESTE S.A	VIAOESTE	
CONC RODOVIAS DO TIETÊ S.A.	ROD TIETE	
CONC ROTA DAS BANDEIRAS S.A.	RT BANDEIRAS	
CONC SIST ANHANG-BANDEIRANT S.A. AUTOBAN	AUTOBAN	
CONSERVAS ODERICH S.A.	ODERICH	
CONSORCIO ALFA DE ADMINISTRACAO S.A.	ALFA CONSORC	
CONSTRUTORA ADOLPHO LINDENBERG S.A.	CONST A LIND	
CONSTRUTORA TENDA S.A.	TENDA	NM
CORREA RIBEIRO S.A. COMERCIO E INDUSTRIA	COR RIBEIRO	
COSAN LOGISTICA S.A.	COSAN LOG	NM
COSAN S.A.	COSAN	NM
CPFL ENERGIA S.A.	CPFL ENERGIA	NM
CPFL ENERGIAS RENOVÁVEIS S.A.	CPFL RENOVAV	NM
CPFL GERACAO DE ENERGIA S.A.	CPFL GERACAO	
CR2 EMPREENDIMENTOS IMOBILIARIOS S.A.	CR2	NM
CRISTAL PIGMENTOS DO BRASIL S.A.	CRISTAL	
CSU CARDSYSTEM S.A.	CSU CARDSYST	NM
CTC - CENTRO DE TECNOLOGIA CANAVIEIRA S.A.	CTC S.A.	MA
CTEEP - CIA TRANSMISSÃO ENERGIA ELÉTRICA PAULISTA	TRAN PAULIST	N1
CVC BRASIL OPERADORA E AGÊNCIA DE VIAGENS S.A.	CVC BRASIL	NM
CYRELA BRAZIL REALTY S.A.EMPREEND E PART	CYRELA REALT	NM
CYRELA COMMERCIAL PROPERT S.A. EMPR PART	CYRE COM-CCP	NM
DIAGNOSTICOS DA AMERICA S.A.	DASA	
DIBENS LEASING S.A. - ARREND.MERCANTIL	DIBENS LSG	
DIMED S.A. DISTRIBUIDORA DE MEDICAMENTOS	DIMED	
DIRECIONAL ENGENHARIA S.A.	DIRECIONAL	NM
DOHLER S.A.	DOHLER	
DOMMO ENERGIA S.A.	DOMMO	
DTCOM - DIRECT TO COMPANY S.A.	DTCOM-DIRECT	
DURATEX S.A.	DURATEX	NM
ECO SECURITIZADORA DIREITOS CRED AGRONEGÓCIO S.A.	ECO SEC AGRO	MB
ECORODOVIAS CONCESSÕES E SERVIÇOS S.A.	ECON	
ECORODOVIAS INFRAESTRUTURA E LOGÍSTICA S.A.	ECORODOVIAS	NM
EDP - ENERGIAS DO BRASIL S.A.	ENERGIAS BR	NM
EDP ESPIRITO SANTO DISTRIBUIÇÃO DE ENERGIA S.A.	ESCELSA	
EDP SÃO PAULO DISTRIBUIÇÃO DE ENERGIA S.A.	EBE	
ELECTRO ACO ALTONA S.A.	ACO ALTONA	
ELEKEIROZ S.A.	ELEKEIROZ	
ELEKTRO REDES S.A.	ELEKTRO	
ELETROBRÁS PARTICIPAÇÕES S.A. - ELETROPAR	ELETROPAR	
ELETRON S.A.	ELETRON	MB
ELETROPAULO METROP. ELET. SAO PAULO S.A.	ELETROPAULO	NM
EMAE - EMPRESA METROP.AGUAS ENERGIA S.A.	EMAE	
EMBRAER S.A.	EMBRAER	NM
EMPRESA CONC RODOV DO NORTE S.A.ECONORTE	ECONORTE	
EMPRESA NAC COM REDITO PART S.A.ENCORPAR	ENCORPAR	
ENAUTA PARTICIPAÇÕES S.A.	ENAUTA PART	NM
ENERGISA MATO GROSSO DO SUL - DIST DE ENERGIA S.A.	ENERSUL	
ENERGISA MATO GROSSO-DISTRIBUIDORA DE ENERGIA S/A	ENERGISA MT	
ENERGISA S.A.	ENERGISA	N2
ENEVA S.A	ENEVA	NM
ENGIE BRASIL ENERGIA S.A.	ENGIE BRASIL	NM
EQUATORIAL ENERGIA S.A.	EQUATORIAL	NM
ESTACIO PARTICIPACOES S.A.	ESTACIO PART	NM
ETERNIT S.A.	ETERNIT	NM
EUCATEX S.A. INDUSTRIA E COMERCIO	EUCATEX	N1
EVEN CONSTRUTORA E INCORPORADORA S.A.	EVEN	NM
EXCELSIOR ALIMENTOS S.A.	EXCELSIOR	
EZ TEC EMPREEND. E PARTICIPACOES S.A.	EZTEC	NM
FERREIRA GOMES ENERGIA S.A.	FGENERGIA	
FERROVIA CENTRO-ATLANTICA S.A.	FER C ATLANT	
FERTILIZANTES HERINGER S.A.	FER HERINGER	NM
FINANCEIRA ALFA S.A.- CRED FINANC E INVS	ALFA FINANC	
FINANSINOS S.A.- CREDITO FINANC E INVEST	FINANSINOS	
FLEURY S.A.	FLEURY	NM
FLEX GESTÃO DE RELACIONAMENTOS S.A.	FLEX S/A	MA
FRAS-LE S.A.	FRAS-LE	N1
GAFISA S.A.	GAFISA	NM
GAIA AGRO SECURITIZADORA S.A.	GAIA AGRO	
GAIA SECURITIZADORA S.A.	GAIA SECURIT	MB
GAMA PARTICIPACOES S.A.	GAMA PART	MB
GENERAL SHOPPING E OUTLETS DO BRASIL S.A.	GENERALSHOPP	NM
GERDAU S.A.	GERDAU	N1
GOL LINHAS AEREAS INTELIGENTES S.A.	GOL	N2
GP INVESTMENTS, LTD.	GP INVEST	DR3
GPC PARTICIPACOES S.A.	GPC PART	
GRAZZIOTIN S.A.	GRAZZIOTIN	
GRENDENE S.A.	GRENDENE	NM
GRUPO SBF SA	CENTAURO	NM
GUARARAPES CONFECCOES S.A.	GUARARAPES	
HAGA S.A. INDUSTRIA E COMERCIO	HAGA S/A	
HAPVIDA PARTICIPACOES E INVESTIMENTOS SA	HAPVIDA	NM
HELBOR EMPREENDIMENTOS S.A.	HELBOR	NM
HERCULES S.A. FABRICA DE TALHERES	HERCULES	
HOTEIS OTHON S.A.	HOTEIS OTHON	
HYPERA S.A.	HYPERA	NM
IDEIASNET S.A.	IDEIASNET	
IGB ELETRÔNICA S/A	IGB S/A	
IGUA SANEAMENTO S.A.	IGUA SA	MA
IGUATEMI EMPRESA DE SHOPPING CENTERS S.A	IGUATEMI	NM
INDUSTRIAS J B DUARTE S.A.	J B DUARTE	
INDUSTRIAS ROMI S.A.	INDS ROMI	NM
INEPAR S.A. INDUSTRIA E CONSTRUCOES	INEPAR	
INNCORP S.A.	SELECTPART	MB
INSTITUTO HERMES PARDINI S.A.	IHPARDINI	NM
INTER CONSTRUTORA E INCORPORADORA S.A.	INTER SA	MA
INTERNATIONAL MEAL COMPANY ALIMENTACAO S.A.	IMC S/A	NM
INVESTIMENTOS BEMGE S.A.	INVEST BEMGE	
INVESTIMENTOS E PARTICIP. EM INFRA S.A. - INVEPAR	INVEPAR	MB
IOCHPE MAXION S.A.	IOCHP-MAXION	NM
IRB - BRASIL RESSEGUROS S.A.	IRBBRASIL RE	NM
ITAPEBI GERACAO DE ENERGIA S.A.	ITAPEBI	
ITAU UNIBANCO HOLDING S.A.	ITAUUNIBANCO	N1
ITAUSA INVESTIMENTOS ITAU S.A.	ITAUSA	N1
ITAUTEC S.A. - GRUPO ITAUTEC	ITAUTEC	
J. MACEDO S.A.	J.MACEDO	
JBS S.A.	JBS	NM
JEREISSATI PARTICIPACOES S.A.	JEREISSATI	
JHSF PARTICIPACOES S.A.	JHSF PART	NM
JOAO FORTES ENGENHARIA S.A.	JOAO FORTES	
JOSAPAR-JOAQUIM OLIVEIRA S.A. - PARTICIP	JOSAPAR	
JSL S.A.	JSL	NM
KARSTEN S.A.	KARSTEN	
KEPLER WEBER S.A.	KEPLER WEBER	
KLABIN S.A.	KLABIN S/A	N2
KROTON EDUCACIONAL S.A.	KROTON	NM
LIBRA TERMINAL RIO S.A.	LIBRA T RIO	
LIGHT S.A.	LIGHT S/A	NM
LIGHT SERVICOS DE ELETRICIDADE S.A.	LIGHT	
LINX S.A.	LINX	NM
LIQ PARTICIPAÇÕES S.A.	LIQ	NM
LITEL PARTICIPACOES S.A.	LITEL	MB
LOCALIZA RENT A CAR S.A.	LOCALIZA	NM
LOG COMMERCIAL PROPERTIES	LOG COM PROP	NM
LOG-IN LOGISTICA INTERMODAL S.A.	LOG-IN	NM
LOJAS AMERICANAS S.A.	LOJAS AMERIC	N1
LOJAS RENNER S.A.	LOJAS RENNER	NM
LONGDIS S.A.	LONGDIS	MB
LPS BRASIL - CONSULTORIA DE IMOVEIS S.A.	LOPES BRASIL	NM
LUPATECH S.A.	LUPATECH	NM
M.DIAS BRANCO S.A. IND COM DE ALIMENTOS	M.DIASBRANCO	NM
MAESTRO LOCADORA DE VEICULOS S.A.	MAESTROLOC	MA
MAGAZINE LUIZA S.A.	MAGAZ LUIZA	NM
MAHLE-METAL LEVE S.A.	METAL LEVE	NM
MANGELS INDUSTRIAL S.A.	MANGELS INDL	
MANUFATURA DE BRINQUEDOS ESTRELA S.A.	ESTRELA	
MARCOPOLO S.A.	MARCOPOLO	N2
MARFRIG GLOBAL FOODS S.A.	MARFRIG	NM
MARISA LOJAS S.A.	LOJAS MARISA	NM
MENDES JUNIOR ENGENHARIA S.A.	MENDES JR	
MERCANTIL BRASIL FINANC S.A. C.F.I.	MERC FINANC	
METALFRIO SOLUTIONS S.A.	METALFRIO	NM
METALGRAFICA IGUACU S.A.	METAL IGUACU	
METALURGICA GERDAU S.A.	GERDAU MET	N1
METALURGICA RIOSULENSE S.A.	RIOSULENSE	
METISA METALURGICA TIMBOENSE S.A.	METISA	
MGI - MINAS GERAIS PARTICIPAÇÕES S.A.	MGI PARTICIP	
MILLS ESTRUTURAS E SERVIÇOS DE ENGENHARIA S.A.	MILLS	NM
MINASMAQUINAS S.A.	MINASMAQUINA	
MINERVA S.A.	MINERVA	NM
MINUPAR PARTICIPACOES S.A.	MINUPAR	
MMX MINERACAO E METALICOS S.A.	MMX MINER	NM
MONTEIRO ARANHA S.A.	MONT ARANHA	
MOVIDA PARTICIPACOES SA	MOVIDA	NM
MRS LOGISTICA S.A.	MRS LOGIST	MB
MRV ENGENHARIA E PARTICIPACOES S.A.	MRV	NM
MULTIPLAN - EMPREEND IMOBILIARIOS S.A.	MULTIPLAN	N2
MUNDIAL S.A. - PRODUTOS DE CONSUMO	MUNDIAL	
NADIR FIGUEIREDO IND E COM S.A.	NADIR FIGUEI	
NATURA COSMETICOS S.A.	NATURA	NM
NEOENERGIA S.A.	NEOENERGIA	MB
NORDON INDUSTRIAS METALURGICAS S.A.	NORDON MET	
NORTEC QUÍMICA S.A.	NORTCQUIMICA	MA
NOTRE DAME INTERMEDICA PARTICIPACOES SA	INTERMEDICA	NM
NUTRIPLANT INDUSTRIA E COMERCIO S.A.	NUTRIPLANT	MA
OCTANTE SECURITIZADORA S.A.	OCTANTE SEC	
ODONTOPREV S.A.	ODONTOPREV	NM
OI S.A.	OI	N1
OMEGA GERAÇÃO S.A.	OMEGA GER	NM
OPPORTUNITY ENERGIA E PARTICIPACOES S.A.	OPPORT ENERG	MB
OSX BRASIL S.A.	OSX BRASIL	NM
OURINVEST SECURITIZADORA SA	OURINVESTSEC	
OURO FINO SAUDE ANIMAL PARTICIPACOES S.A.	OUROFINO S/A	NM
OURO VERDE LOCACAO E SERVICO S.A.	OURO VERDE	
PANATLANTICA S.A.	PANATLANTICA	
PARANA BCO S.A.	PARANA	
PARANAPANEMA S.A.	PARANAPANEMA	NM
PATRIA CIA SECURITIZADORA DE CRED IMOB	PATRIA SEC	
PBG S/A	PORTOBELLO	NM
PDG COMPANHIA SECURITIZADORA	PDG SECURIT	
PDG REALTY S.A. EMPREEND E PARTICIPACOES	PDG REALT	NM
PETRO RIO S.A.	PETRORIO	NM
PETROBRAS DISTRIBUIDORA S/A	PETROBRAS BR	NM
PETROLEO BRASILEIRO S.A. PETROBRAS	PETROBRAS	N2
PETTENATI S.A. INDUSTRIA TEXTIL	PETTENATI	
PLASCAR PARTICIPACOES INDUSTRIAIS S.A.	PLASCAR PART	
POLO CAPITAL SECURITIZADORA S.A	POLO CAP SEC	
POLPAR S.A.	POLPAR	
POMIFRUTAS S/A	POMIFRUTAS	NM
PORTO SEGURO S.A.	PORTO SEGURO	NM
PORTO SUDESTE V.M. S.A.	PORTO VM	
POSITIVO TECNOLOGIA S.A.	POSITIVO TEC	NM
PPLA PARTICIPATIONS LTD.	PPLA	DR3
PRATICA KLIMAQUIP INDUSTRIA E COMERCIO SA	PRATICA	M2
PRINER SERVIÇOS INDUSTRIAIS S.A.	PRINER	MA
PRODUTORES ENERGET.DE MANSO S.A.- PROMAN	PROMAN	MB
PROFARMA DISTRIB PROD FARMACEUTICOS S.A.	PROFARMA	NM
PROMPT PARTICIPACOES S.A.	PROMPT PART	MB
QUALICORP CONSULTORIA E CORRETORA DE SEGUROS S.A.	QUALICORP	NM
QUALITY SOFTWARE S.A.	QUALITY SOFT	MA
RAIA DROGASIL S.A.	RAIADROGASIL	NM
RAIZEN ENERGIA S.A.	RAIZEN ENERG	
RANDON S.A. IMPLEMENTOS E PARTICIPACOES	RANDON PART	N1
RB CAPITAL COMPANHIA DE SECURITIZAÇÃO	RBCAPITALRES	MB
RB CAPITAL SECURITIZADORA S.A.	RBCAPITALSEC	MB
REAL AI PIC SEC DE CREDITOS IMOBILIARIO S.A.	WTORRE PIC	
RECRUSUL S.A.	RECRUSUL	
REDE ENERGIA PARTICIPAÇÕES S.A.	REDE ENERGIA	
REFINARIA DE PETROLEOS MANGUINHOS S.A.	PET MANGUINH	
RENOVA ENERGIA S.A.	RENOVA	N2
RESTOQUE COMÉRCIO E CONFECÇÕES DE ROUPAS S.A.	LE LIS BLANC	NM
RGE SUL DISTRIBUIDORA DE ENERGIA S.A.	AES SUL	
RIO PARANAPANEMA ENERGIA S.A.	GER PARANAP	
RNI NEGÓCIOS IMOBILIÁRIOS S.A.	RNI	NM
RODOVIAS DAS COLINAS S.A.	ROD COLINAS	
ROSSI RESIDENCIAL S.A.	ROSSI RESID	NM
RUMO MALHA NORTE S.A.	ALL NORTE	MB
RUMO MALHA PAULISTA S.A.	ALL PAULISTA	MB
RUMO S.A.	RUMO S.A.	NM
SALUS INFRAESTRUTURA PORTUARIA SA	SALUS INFRA	
SANESALTO SANEAMENTO S.A.	SANESALTO	
SANSUY S.A. INDUSTRIA DE PLASTICOS	SANSUY	
SANTHER FAB DE PAPEL STA THEREZINHA S.A.	SANTHER	
SANTO ANTONIO ENERGIA S.A.	STO ANTONIO	
SANTOS BRASIL PARTICIPACOES S.A.	SANTOS BRP	NM
SAO CARLOS EMPREEND E PARTICIPACOES S.A.	SAO CARLOS	NM
SAO MARTINHO S.A.	SAO MARTINHO	NM
SAO PAULO TURISMO S.A.	SPTURIS	
SARAIVA LIVREIROS S.A. - EM RECUPERAÇÃO JUDICIAL	SARAIVA LIVR	N2
SCHULZ S.A.	SCHULZ	
SER EDUCACIONAL S.A.	SER EDUCA	NM
SIDERURGICA J. L. ALIPERTI S.A.	ALIPERTI	
SINQIA S.A.	SINQIA	NM
SLC AGRICOLA S.A.	SLC AGRICOLA	NM
SMARTFIT ESCOLA DE GINÁSTICA E DANÇA S.A.	SMART FIT	M2
SMILES FIDELIDADE S.A.	SMILES	NM
SONAE SIERRA BRASIL S.A.	SIERRABRASIL	NM
SONDOTECNICA ENGENHARIA SOLOS S.A.	SONDOTECNICA	
SPRINGER S.A.	SPRINGER	
SPRINGS GLOBAL PARTICIPACOES S.A.	SPRINGS	NM
STARA S.A. - INDÚSTRIA DE IMPLEMENTOS AGRÍCOLAS	STARA	MA
STATKRAFT ENERGIAS RENOVAVEIS S.A.	STATKRAFT	
SUDESTE S.A.	SUDESTE S/A	MB
SUL 116 PARTICIPACOES S.A.	SUL 116 PART	MB
SUL AMERICA S.A.	SUL AMERICA	N2
SUZANO HOLDING S.A.	SUZANO HOLD	
SUZANO S.A.	SUZANO S.A.	NM
T4F ENTRETENIMENTO S.A.	TIME FOR FUN	NM
TARPON INVESTIMENTOS S.A.	TARPON INV	NM
TAURUS ARMAS S.A.	FORJA TAURUS	N2
TCP TERMINAL DE CONTEINERES DE PARANAGUA SA	TCP TERMINAL	
TEC TOY S.A.	TECTOY	
TECHNOS S.A.	TECHNOS	NM
TECNISA S.A.	TECNISA	NM
TECNOSOLO ENGENHARIA S.A.	TECNOSOLO	
TEGMA GESTAO LOGISTICA S.A.	TEGMA	NM
TEKA-TECELAGEM KUEHNRICH S.A.	TEKA	
TEKNO S.A. - INDUSTRIA E COMERCIO	TEKNO	
TELEC BRASILEIRAS S.A. TELEBRAS	TELEBRAS	
TELEFÔNICA BRASIL S.A	TELEF BRASIL	
TERMELÉTRICA PERNAMBUCO III S.A.	TERM. PE III	
TERMINAL GARAGEM MENEZES CORTES S.A.	MENEZES CORT	MB
TERMOPERNAMBUCO S.A.	TERMOPE	
TERRA SANTA AGRO S.A.	TERRA SANTA	NM
TEXTIL RENAUXVIEW S.A.	TEX RENAUX	
TIM PARTICIPACOES S.A.	TIM PART S/A	NM
TOTVS S.A.	TOTVS	NM
TPI - TRIUNFO PARTICIP. E INVEST. S.A.	TRIUNFO PART	NM
TRANSMISSORA ALIANÇA DE ENERGIA ELÉTRICA S.A.	TAESA	N2
TREVISA INVESTIMENTOS S.A.	TREVISA	
TRIÂNGULO DO SOL AUTO-ESTRADAS S.A.	TRIANGULOSOL	
TRISUL S.A.	TRISUL	NM
TRUE SECURITIZADORA S.A.	APICESECURIT	
TUPY S.A.	TUPY	NM
ULTRAPAR PARTICIPACOES S.A.	ULTRAPAR	NM
UNICASA INDÚSTRIA DE MÓVEIS S.A.	UNICASA	NM
UNIDAS S.A.	UNIDAS	
UNIPAR CARBOCLORO S.A.	UNIPAR	
UPTICK PARTICIPACOES S.A.	UPTICK	MB
USINAS SID DE MINAS GERAIS S.A.-USIMINAS	USIMINAS	N1
VALE S.A.	VALE	NM
VALID SOLUÇÕES S.A.	VALID	NM
VERT COMPANHIA SECURITIZADORA	VERTCIASEC	
VIA VAREJO S.A.	VIAVAREJO	NM
VIVER INCORPORADORA E CONSTRUTORA S.A.	VIVER	NM
VULCABRAS/AZALEIA S.A.	VULCABRAS	NM
WEG S.A.	WEG	NM
WETZEL S.A.	WETZEL S/A	
WHIRLPOOL S.A.	WHIRLPOOL	
WILSON SONS LTD.	WILSON SONS	DR3
WIZ SOLUÇÕES E CORRETAGEM DE SEGUROS S.A.	WIZ S.A.	NM
WLM PART. E COMÉRCIO DE MÁQUINAS E VEÍCULOS S.A.	WLM IND COM	
